able-bodied	flowerpot	nevertheless	snowfall
aftereffect	flyby	newborn	snowflake
afternoon	flyweight	newcomer	snowman
afterthought	flywheel	newsletter	snowplow
airbag	foghorn	newspaper	snowshoe
aircraft	folklore	newsstand	snowstorm
airline	follow-up	newsworthy	soapstone
airplane	foolproof	night shift	softball
airport	football	nightfall	software
airtight	foothill	nightgown	somebody
angelfish	footlight	nightmare	someday
another	footman	nightstand	somehow
anybody	footnote	nighttime	someone
anyhow	footprint	nitwit	someplace
anymore	footrest	nobleman	something
anyone	footstep	nobody	sometime
anyplace	footstool	northeast	somewhat
anything	footwear	northwest	somewhere
anytime	forecast	nosebleed	songbird
anyway	foreclose	nosedive	sort out
anywhere	foreman	notebook	sought-after
applesauce	foremost	noteworthy	soundproof
armchair	foreshadow	nothing	soundtrack
armhole	foresight	nowhere	southeast
armpit	forthwith	nutshell	southwest
arrowhead	foursquare	oatmeal	soy sauce
artwork	foxglove	off-site	soybean
ask out	foxhole	offline	spacecraft
awestruck	framework	offshoot	spaceship
backache	freelance	offshore	spacesuit
backbone	freeway	offside	spareribs
backdrop	freshman	offspring	speakeasy
background	freshwater	oilcan	spellbound
backhand	friendship	on-site	spoilsport
backhoe	frogman	oncoming	sportscast
backlog	frostbite	one-sided	sportscaster
backpack	frostbitten	oneself	sportsman
backspace	fruitcake	ongoing	sportsmanship
backstab	full moon	online	sportswoman
backstabbing	full-length	onlooker	sportswriter
backstroke	furthermore	onrush	spotlight
backwater	gallbladder	onset	springboard
backwoods	gallstone	onto	springtime
backyard	gearshift	onward	spyglass
badlands	gemstone	open-minded	stagecoach
bagpipe	gentleman	openhanded	staircase
ballplayer	get across	otherwise	stairway
bantamweight	get along	ourselves	standby
barcode	get away with	outbid	standoff
barefoot	get back	outbreak	standpipe
barnstorm	get over	outburst	standstill
barnyard	ghostwriter	outcast	starboard
baseball	gingerbread	outcome	starfish
basketball	give away	outcrop	stargazer
bathmat	give in to	outcry	stargazing
bathrobe	give up	outdated	starlight
bathroom	globetrotter	outdo	starship
bathtub	glowworm	outdoor	startup
bathwater	go after	outdoors	stateside
battle cry	go ahead	outdoorsman	statesman
battle-ax	go around	outfield	stateswoman
battlecruiser	go back	outfit	steamboat
battlefield	goalkeeper	outflow	steamroller
battleship	goalpost	outfox	steamship
beachcomb	goldenrod	outgas	steeplechase
beachcomber	goldfinch	outgoing	stepbrother
beancurd	goldfish	outgrow	stepchild
become	goldmine	outhouse	stepdaughter
bedrock	goldsmith	outlast	stepfather
bedroom	good-looking	outlaw	stepladder
bedspread	goodnight	outlay	stepmother
bedspring	grammar school	outlet	stepparent
bedtime	grandchild	outline	steppingstone
beehive	granddaughter	outlive	stepsister
beekeeper	grandfather	outlook	stepson
beekeeping	grandma	outlying	stingray
beeswax	grandmother	outnumber	stockbroker
beforehand	grandpa	outpost	stockholder
bellflower	grandparent	output	stockpile
bellhop	grandson	outrage	stomachache
bellyache	grandstand	outrank	stonewall
benchmark	grapefruit	outrun	stoneware
billboard	grapevine	outshine	stonework
birthday	grasshopper	outside	stopwatch
birthplace	grassland	outsider	storehouse
birthrate	gravestone	outskirt	storekeeper
birthright	graveyard	outsmart	storyteller
bitterroot	greenback	outsource	storytelling
bittersweet	greengrocer	outspoken	stowaway
blackberry	greenhorn	outstanding	straightedge
blackbird	greenhouse	outstay	straightforward
blackboard	greyhound	outstretch	strawberry
blacklist	gridlock	outtake	streamline
blackout	grindstone	outward	streetcar
blacksmith	groundbreaking	overabundant	strong-arm
blockbuster	groundcover	overachiever	strongbox
blowout	groundhog	overact	stronghold
blowup	groundskeeper	overactive	suitcase
bluebell	groundspeed	overage	summertime
blueberry	groundwork	overall	sunbonnet
bluebird	grow apart	overalls	sunburn
bluebonnet	grow up	overarching	sundial
bobcat	grownup	overbearing	sundown
bobtail	guidebook	overbite	sundress
bodyguard	guideline	overblown	sunfish
bookbinder	guidepost	overboard	sunflower
bookbinding	gumdrop	overbook	sunglasses
bookcase	gunfire	overburden	sunlight
bookkeeper	gunmetal	overcast	sunrise
bookmark	gunpowder	overcharge	sunset
bookmobile	hacksaw	overcoat	sunshine
bookshelf	hailstone	overcome	sunspot
bookstore	hailstorm	overcompensate	sunstroke
bookworm	hairbrush	overcook	sunup
bowleg	haircut	overcrowd	supercharge
box cutter	hairdo	overdo	supercollider
box spring	hairdresser	overdose	supercomputer
boxcar	hairline	overdraft	superconductor
brainstorm	halfback	overdress	superfood
brainwash	halfhearted	overdrive	supergiant
breadbasket	halfway	overdue	superglue
breadbox	halfwit	overeager	
superheavyweight
breadcrumb	hallway	overeat	superhero
breadfruit	hamburger	overexpose	superhighway
breadknife	hand towel	overfill	superhuman
breadstick	handbag	overflow	superimpose
break into	handball	overfull	superman
breakdancing	handbook	overgrown	supermarket
breakdown	handcuff	overhand	supernatural
breakfast	handgun	overhang	supernova
breakfront	handheld	overhaul	supertanker
breakneck	handhold	overhead	superuser
breakout	handkerchief	overhear	superwoman
breakthrough	handlebar	overheat	surfboard
breakup	handmade	overkill	swallowtail
breakwater	handover	overland	sweatshirt
breastbone	handprint	overlap	sweetheart
breaststroke	handrail	overlay	swimsuit
bridegroom	handset	overload	switch off
briefcase	handshake	overlook	switch on
bringdown	handspring	overlord	swordfish
browbeat	handstand	overlying	tablecloth
brown-eyed	handwork	overnight	tableland
bucktoothed	handwriting	overpack	tablespoon
bulkhead	handyman	overpaid	tabletop
bulldog	hangman	overpass	tailback
bulldozer	hangnail	overpay	tailspin
bullfrog	hangout	overpower	take back
businessman	hardheaded	overrate	takeaway
businesswoman	hardhearted	overreach	takeoff
buttercup	hardtop	overreact	takeout
butterfingers	hardware	override	takeover
butterfly	hardwire	overrule	tapeworm
buttermilk	hardworking	overrun	tattletale
buttonhole	hayfield	overseas	taxicab
bygone	hayfork	oversee	teacake
bypass	hayloft	overshoe	teacup
call off	hayride	oversight	teammate
callback	haystack	oversleep	teapot
campfire	haywire	overstate	teardrop
candlestick	hazelnut	overstretch	tearjerker
candytuft	headache	overtake	tearoom
cannot	headboard	overtax	teashop
cardboard	headdress	overthrow	teaspoon
carefree	headfirst	overtime	teatime
careless	headhunter	overturn	telltale
caretaker	headland	overuse	textbook
carpool	headlight	overvalue	thanksgiving
carport	headline	overview	themselves
cartwheel	headphone	overweight	thighbone
catch up	headquarters	overwork	think over
catfish	headrest	oxbow	think up
catnap	headset	pancake	thoroughbred
catnip	headstand	panhandle	thoroughfare
cell phone	headstone	paperback	threadbare
chairman	headwaters	paperweight	
three-dimensional
chairperson	headway	paperwork	throughout
chairwoman	heartbeat	parkway	thumbnail
cheapskate	heartburn	part-time	thunderbolt
check in	heartsick	pass away	thunderclap
checkerboard	heavyweight	pass on	thundercloud
checkmate	hedgehog	passageway	thunderstorm
checkroom	help desk	passbook	thunderstruck
checkup	hereafter	passerby	tideland
cheer up	heretofore	passionflower	tightrope
chestnut	herringbone	passionfruit	time-saver
chickpea	herself	passkey	time-saving
childbearing	hideaway	passport	timecard
childbirth	high school	password	timekeeper
childcare	high-rise	pastureland	timeline
childfree	high-tech	patchwork	timeout
childless	high-water	pathfinder	timepiece
childlike	high-wire	pathway	timescale
childproof	highbrow	pawnbroker	timesheet
chopstick	highchair	payback	timetable
classmate	highflier	payroll	timeworn
classroom	highhanded	peacekeeper	tip-off
classwork	highjack	peacemaker	tiptoe
clean-cut	highland	peanut	toadstool
clockwise	highlander	penknife	today
clockwork	highlight	peppercorn	toenail
close-up	highroad	peppermint	tombstone
closed-minded	hightail	pickax	tomcat
clotheshorse	highway	pickpocket	toolbox
clothesline	highwayman	piecrust	toothbrush
clothespin	hijack	pigeonhole	toothpaste
coastline	hillside	piggyback	toothpick
cobweb	hilltop	pigpen	topcoat
cold sore	himself	pigskin	topflight
coldhearted	hindsight	pigsty	topknot
come about	hogtie	pigtail	topsail
come apart	hogwash	pillbox	topside
come around	hollyhock	pillowcase	topsoil
come down with	homecoming	pincushion	topspin
common sense	homeland	pine cone	topstitch
cookbook	homemade	pineapple	toss-up
cookout	homeowner	pinpoint	touchdown
cooktop	homesick	pinprick	trademark
cookware	homeward	pinup	tradeoff
copycat	homework	pinwheel	tradesman
copyright	honeybee	pipefish	tradeswoman
copywriter	honeycomb	pipeline	treadmill
corkscrew	honeydew	pitchfork	treetop
corn dog	honeymoon	plainclothes	triggerfish
cornbread	hookworm	playground	troublemaker
corncob	hopscotch	playpen	trustworthy
cornfield	horseback	plaything	tryout
cornflower	horsefly	plywood	tugboat
cornmeal	horselaugh	pocketbook	tumbledown
cornstalk	horseman	pocketknife	tumbleweed
cottonmouth	horseplay	point out	turncoat
count on	horsepower	polecat	turnout
countdown	horseradish	polestar	turnover
counterattack	horseshoe	policeman	turnpike
counterbalance	hot dog	policewoman	turnstile
counterclockwise	hot-wire	popcorn	turtleneck
counterweight	hotbed	popover	typeface
countryside	hotcake	post office	typewriter
coursework	hothead	postcard	underachiever
courthouse	hotheaded	postmark	underarm
courtyard	hothouse	postmaster	underclothing
cowbell	hotline	potholder	undercook
cowboy	hotrod	pothole	undercover
cowgirl	hotshot	potluck	undercut
cowslip	hourglass	potpie	underdog
crabgrass	houseboat	powerboat	underdone
craftsman	housebreaking	powerhouse	undergo
craftswoman	housecoat	praiseworthy	underground
crawfish	housefly	primrose	undergrowth
crayfish	household	printout	underhand
cross out	housekeeper	proofread	undersea
crossbow	housekeeping	pullover	undershirt
crossroad	housewarming	purebred	understand
crossroads	housewife	pushcart	understated
crosswalk	housework	pushover	undertake
crossword	hovercraft	put away	undertaker
crowbar	however	put down	undervalue
cubbyhole	huckleberry	quarterback	underwater
cupboard	humankind	quartermaster	underwear
cupcake	humbug	queen-size	underweight
cutaway	humdrum	quickfire	underworld
cutback	hummingbird	quicksand	upbeat
cutoff	humpback	quicksilver	upbringing
cutthroat	hunchback	racecar	upcoming
cutup	ice cream	racecourse	update
dance hall	ice cube	racehorse	updraft
daredevil	iceberg	racetrack	upgrade
darkroom	icefish	raceway	uphill
dashboard	in-depth	radio wave	uphold
database	inchworm	railroad	upkeep
daybreak	income	railway	uplift
daydream	indoor	rainbow	upload
daylight	indoors	raincoat	upon
daytime	inkblot	raindrop	uppermost
deadline	inland	rainfall	upright
deck chair	inlet	rainout	uprising
desktop	inmate	rainstorm	uproar
dimwit	inside	rattlesnake	uproot
dining room	instep	real estate	upset
dinner plate	into	red-eye	upstage
dirt bike	inward	redcoat	upstairs
dishcloth	itself	redhead	upstanding
dishwasher	jackfruit	redwood	upstart
dishwater	jackknife	reindeer	upstate
disk drive	jackpot	report card	upstream
do-over	jawbone	rib cage	upswing
dogcatcher	jawbreaker	ringleader	uptake
dogfish	jaybird	ringside	uptown
doghouse	jaywalker	ringworm	upturn
dogwood	jellybean	ripsaw	upward
doorbell	jellyfish	riverbed	upwelling
doorknob	jigsaw	riverside	upwind
doorman	jitterbug	roadbed	username
doormat	joystick	roadrunner	viewpoint
doorstep	jumping jack	roadside	vineyard
doorstop	jumpsuit	roadway	volleyball
doorway	keep up	rockfish	voltmeter
down payment	keepsake	rockhound	waistcoat
down-home	kettledrum	rockslide	waistline
downburst	keyboard	roommate	walkingstick
downcast	keyhole	rosebud	walkout
downdraft	keystone	rosemary	walkway
downfall	keyword	roughhouse	wallflower
downhill	kickoff	roughneck	wallpaper
downlink	killjoy	roundup	wardrobe
download	kindhearted	rowboat	warehouse
downplay	king-size	run into	warfare
downpour	knapsack	run out	warmup
downrate	kneecap	run-in	warpath
downright	knighthood	runaway	warship
downscale	knockout	runner-up	washcloth
downshift	ladybird	runoff	washstand
downsize	ladybug	runway	wasteland
downstairs	lakebed	safeguard	watchdog
downstream	lakeside	sailboat	waterbed
downstroke	landfall	sailfish	watercolor
downthrow	landform	salesman	watercress
downtown	landlord	saleswoman	waterfall
downtrodden	landmark	saltshaker	waterfowl
downturn	landowner	saltwater	waterfront
downward	landslide	sandbar	watermelon
downwind	larkspur	sandbox	waterproof
dragonfly	laughingstock	sandman	watershed
drainpipe	lawnmower	sandpaper	waterspout
dreadlock	lawsuit	sandstorm	watertight
dreadnought	layover	saucepan	waterway
dressmaker	leapfrog	sawdust	waterworks
dressmaking	leftover	sawhorse	wavelength
driftwood	letdown	sawmill	wayside
driveway	levelheaded	scarecrow	weather vane
drop back	life-size	scatterbrain	weatherman
drop in	lifeboat	schoolhouse	weatherproof
drop-down	lifeguard	schoolroom	weatherwoman
dropout	lifelong	schoolteacher	website
drugstore	lifespan	scrapbook	weekday
drumbeat	lifestyle	screwdriver	weekend
drumfire	lifetime	seabed	weightlifter
drumroll	liftoff	seabird	weightlifting
drumstick	lightheaded	seaboard	well-behaved
duckbill	lighthearted	seacoast	well-being
dugout	lighthouse	seafarer	well-educated
dumbbell	lightweight	seafood	well-known
dustpan	limelight	seagoing	well-to-do
duststorm	limestone	seagrass	wetland
earache	line dancing	seagull	wetsuit
eardrum	linebacker	seahorse	whatever
earlobe	lineman	seaplane	whatsoever
earmark	lineup	searchlight	wheelbarrow
earmuff	lionheart	seashell	wheelchair
earphone	lipstick	seashore	whenever
earring	litterbug	seasick	whereas
earshot	livestock	seaside	whereby
earthbound	living room	seat belt	whereupon
earthquake	locksmith	seawall	wherewith
earthward	log in	seaway	wherewithal
earthworm	log off	seaweed	whichever
earwig	log on	seaworthy	whirlpool
eat out	log out	secondhand	whirlwind
eavesdrop	loggerhead	seedpod	whitefish
eggbeater	logjam	self-awareness	whitewall
eggcup	long-lasting	self-concept	whitewash
egghead	longhair	self-service	whoever
eggnog	longhand	setback	wholehearted
eggplant	longshoreman	sheepdog	wholesale
eggshell	look out	shellfish	whomever
elementary school	lookout	shipmate	widescreen
elsewhere	loophole	shipshape	widespread
end up	lopsided	shipwreck	wildcat
evergreen	loudmouth	shipyard	wildfire
everlasting	lovesick	shoehorn	wildflower
everybody	lowbrow	shoelace	wildlife
everyday	lowland	shopkeeper	windbreaker
everyone	lowlife	shoreline	windfall
everything	lukewarm	short-tempered	windmill
everywhere	lumberjack	shortbread	windowpane
eyeball	lunchroom	shortcake	windowsill
eyebrow	lungfish	shorthand	windpipe
eyeglass	mailbox	shortstop	windshield
eyelash	mailman	showman	windsock
eyelid	mainframe	showmanship	windstorm
eyepiece	mainland	showoff	windswept
eyesight	mainstream	shrink-wrap	windward
eyewitness	makeover	shuffleboard	wingspan
fall apart	makeshift	shutdown	wingspread
fall back	makeup	shuteye	wintertime
fall down	manhole	sideboard	wiretap
fall over	manhunt	sidecar	wisecrack
fallout	mankind	sidekick	wishbone
fanfare	manpower	sideline	witchcraft
farewell	marketplace	sidestep	withdraw
farmhouse	marksman	sidestroke	withhold
farmyard	mastermind	sideswipe	within
farsighted	masterpiece	sidetrack	without
fast-moving	matchbook	sidewalk	withstand
fat-free	matchmaker	sideways	wolfhound
father-in-law	matchmaking	sightseeing	wolfsbane
fatherland	maybe	sightseer	wonderland
feedback	mayflower	signpost	woodchuck
fiddlesticks	mealtime	silkworm	woodcutter
fill out	meanwhile	silverware	woodland
fill up	meatball	single-minded	woodpecker
find out	meatloaf	singsong	woodsman
fingernail	merry-go-round	skateboard	woodwork
fingerprint	middle school	skylight	word-of-mouth
fingertip	middle-aged	skyline	workbench
firearm	middleman	skyrocket	workbook
fireboat	midshipman	skyscraper	workday
firebug	milestone	skywriting	workhorse
firefighter	milkshake	slapstick	workman
firefly	mockingbird	slaughterhouse	workout
fireman	mockup	sledgehammer	workplace
fireplace	moonbeam	sleep in	workroom
fireproof	moonlight	sleepover	workshop
firewood	moonstruck	sleepwalker	workstation
firework	moreover	sleepyhead	worktable
firsthand	motorboat	slingshot	world-famous
fishbowl	motorcycle	slipcover	worldwide
fishcake	mousetrap	slipknot	worthwhile
fisherman	mouthpiece	slipshod	wristwatch
fisherwoman	mouthwatering	small talk	wrongdoing
fisheye	muskrat	small-minded	yachtsman
fishhook	myself	smallpox	yachtswoman
fishnet	namesake	smokestack	yard sale
flagpole	nearsighted	snapdragon	yardarm
flapjack	necklace	snapshot	yardstick
flashlight	neckline	snowball	yearbook
flatfish	necktie	snowboard	yellowtail
floodlight	needlepoint	snowbound	yourself
floorboard	needlework	snowdrift	zigzag
flowerbed	network	snowdrop	zookeeper
