A
afternoon	afterthought	airborne	airline
airmail	airplane	airport	airtight
anchorperson	another	anybody	anyone
anyplace	anything	anytime	awestruck
anyway	anywhere	applesauce	audiotape
B
backache	backboard	backbone	backbreaking
backfire	background	backlash	backpack
backup	backyard	ballpark	ballroom
barefoot	baseball	basketball	bathroom
bedrock	bedroom	bedspread	beforehand
benchmark	birdhouse	birthday	blackbird
blackboard	blowup	blueprint	bookstore
boyfriend	brainstorm	breakdown	breakfast
breathtaking	broadcast	buildup	bulldog
burnout	buttermilk	byproduct
C
campfire	cannot	caregiver	carpool
carryover	chalkboard	checkout	churchgoer
citywide	classmate	cleanup	clipboard
cockpit	colorblind	cookbook	cooperative
copperhead	copyright	countryside	cowboy
crosswalk	cupcake
D
database	daydream	daylight	daytime
desktop	doorbell	doorknob	downpour
downstairs	drawbridge	driveway	drugstore
dugout
E
earring	earthquake	earthworm	easygoing
everybody	everywhere	everyone	everything
everyday	extracurricular	eyeball	eyebrow
eyelid	everywhere
F
fingernail	fingerprint	firefighter	fireplace
fireproof	firewood	fireworks	flashback
flashlight	flowchart	flowerpot	folklore
football	forever	freelance	freshwater
frostbite
G
gentlemen	gingerbread	girlfriend	goldfish
grandchildren	grandfather	grandmother	grandparent
grapefruit	grasshopper	gridlock	groundwater
grownup
H
haircut	hamburger	handcuff	handlebar
handshake	haystack	headache	headlight
headquarter	headset	heartwarming	herringbone
herself	highway	hilltop	himself
homemade	homeowner	homesick	homework
however
I
iceberg	icebox	icebreaker	inchworm
indoor	infield	inside	into
itself	innkeeper
J
jackknife	jackpot	jackrabbit	jawbone
jaywalk	jellyfish	jigsaw	jumpsuit
K
keyboard	kickoff	knucklehead	keepsake
kettledrum	kickball	keyhole	keynote
killjoy	kindhearted	kneecap	knighthood
knothole	knucklehead	keystone
L
leapfrog	ladybug	landlord	leftover
lifeboat	lifeguard	lifestyle	lightheaded
lighthouse	lightweight	lipstick	longshoremen
loudspeaker
M
makeup	marketplace	maybe	meantime
meanwhile	miniskirt	moonlight	motorcycle
myself
N
nationwide	network	nevertheless	newscast
newspaper	nightgown	nobody	notebook
nowhere
O
oatmeal	ongoing	online	ourselves
outcome	outfield	outfit	outlaw
outline	outside	outsource	outstanding
overalls	overcoat	overexposure	overkill
overlook	overpass
P
pancake	paperback	paperwork	payoff
payroll	peanuts	peppermint	percent
pinball	playground	playmate	ponytail
popcorn	postcard	pothole	printout
proofread
Q
quarrelsome	quarterback	quartermaster	quicksand
quicksilver
R
railroad	rainbow	raincoat	rattlesnake
rawhide	redhead	redwood	rollerblade
rollout	runway
S
sagebrush	sailboat	sandpaper	scarecrow
scatterbrain	screwdriver	seacoast	seafood
seagull	seaport	seashell	seaside
seaweed	seesaw	shipwreck	shoelace
shortstop	shutdown	showoff	showroom
sidewalk	silverware	skateboard	skyscraper
snowball	snowfall	snowflake	snowman
snowplow	snowshoe	snowstorm	softball
somebody	someday	somehow	someone
someplace	something	sometimes	somewhat
somewhere	spacewalk	spotlight	spreadsheet
springtime	starfish	statewide	stepbrother
stepfather	stepmother	stepsister	storyteller
straightforward	strawberry	sugarcoat	suitcase
summertime	sundown	sunflower	sunlight
sunrise	sunset	sunshine	sunstroke
suntan	superhighway	sweatshirt
T
tablecloth	teammate	textbook	Thanksgiving
themselves	thunderstorm	timetable	tiptoe
today	toenail	together	toothbrush
touchdown	trailblazer	tryout	tugboat
turnaround	turnpike	turtleneck
U
undercover	underdog	underground	understatement
undertake	upstairs	uptown	uproot
upset
V
venturesome	videocassette	videotape	vineyard
viewfinder	viewpoint	volleyball	vouchsafe
W
wastebasket	watercolor	waterfall	waterfront
watermelon	weatherperson	webpage	weekday
weekend	wheelchair	whenever	whirlpool
whiteboard	wholesale	windmill	windpipe
windshield	windsurfing	wingspan	wiretapping
without	woodland	woodpecker	workday
workforce	workload	workplace	workshop
workstation	wristwatch	wrongdoing
Y
yardarm	yardstick	yearbook	yourself
Z
zookeeper
